#########################
#    XO# X O           O#
#   OX  X  X ############
#    X     P            #
#           #    XX     #
#O          #    XO     #
#       O   #     O    O#
#########################